./FWIOpenData/FlatVel_A/data/data1.npy	./FWIOpenData/FlatVel_A/model/model1.npy
./FWIOpenData/FlatVel_A/data/data2.npy	./FWIOpenData/FlatVel_A/model/model2.npy
./FWIOpenData/FlatVel_A/data/data3.npy	./FWIOpenData/FlatVel_A/model/model3.npy
./FWIOpenData/FlatVel_A/data/data4.npy	./FWIOpenData/FlatVel_A/model/model4.npy
./FWIOpenData/FlatVel_A/data/data5.npy	./FWIOpenData/FlatVel_A/model/model5.npy
./FWIOpenData/FlatVel_A/data/data6.npy	./FWIOpenData/FlatVel_A/model/model6.npy
./FWIOpenData/FlatVel_A/data/data7.npy	./FWIOpenData/FlatVel_A/model/model7.npy
./FWIOpenData/FlatVel_A/data/data8.npy	./FWIOpenData/FlatVel_A/model/model8.npy
./FWIOpenData/FlatVel_A/data/data9.npy	./FWIOpenData/FlatVel_A/model/model9.npy
./FWIOpenData/FlatVel_A/data/data10.npy	./FWIOpenData/FlatVel_A/model/model10.npy
./FWIOpenData/FlatVel_A/data/data11.npy	./FWIOpenData/FlatVel_A/model/model11.npy
./FWIOpenData/FlatVel_A/data/data12.npy	./FWIOpenData/FlatVel_A/model/model12.npy
./FWIOpenData/FlatVel_A/data/data13.npy	./FWIOpenData/FlatVel_A/model/model13.npy
./FWIOpenData/FlatVel_A/data/data14.npy	./FWIOpenData/FlatVel_A/model/model14.npy
./FWIOpenData/FlatVel_A/data/data15.npy	./FWIOpenData/FlatVel_A/model/model15.npy
./FWIOpenData/FlatVel_A/data/data16.npy	./FWIOpenData/FlatVel_A/model/model16.npy
./FWIOpenData/FlatVel_A/data/data17.npy	./FWIOpenData/FlatVel_A/model/model17.npy
./FWIOpenData/FlatVel_A/data/data18.npy	./FWIOpenData/FlatVel_A/model/model18.npy
./FWIOpenData/FlatVel_A/data/data19.npy	./FWIOpenData/FlatVel_A/model/model19.npy
./FWIOpenData/FlatVel_A/data/data20.npy	./FWIOpenData/FlatVel_A/model/model20.npy
./FWIOpenData/FlatVel_A/data/data21.npy	./FWIOpenData/FlatVel_A/model/model21.npy
./FWIOpenData/FlatVel_A/data/data22.npy	./FWIOpenData/FlatVel_A/model/model22.npy
./FWIOpenData/FlatVel_A/data/data23.npy	./FWIOpenData/FlatVel_A/model/model23.npy
./FWIOpenData/FlatVel_A/data/data24.npy	./FWIOpenData/FlatVel_A/model/model24.npy
./FWIOpenData/FlatVel_A/data/data25.npy	./FWIOpenData/FlatVel_A/model/model25.npy
./FWIOpenData/FlatVel_A/data/data26.npy	./FWIOpenData/FlatVel_A/model/model26.npy
./FWIOpenData/FlatVel_A/data/data27.npy	./FWIOpenData/FlatVel_A/model/model27.npy
./FWIOpenData/FlatVel_A/data/data28.npy	./FWIOpenData/FlatVel_A/model/model28.npy
./FWIOpenData/FlatVel_A/data/data29.npy	./FWIOpenData/FlatVel_A/model/model29.npy
./FWIOpenData/FlatVel_A/data/data30.npy	./FWIOpenData/FlatVel_A/model/model30.npy
./FWIOpenData/FlatVel_A/data/data31.npy	./FWIOpenData/FlatVel_A/model/model31.npy
./FWIOpenData/FlatVel_A/data/data32.npy	./FWIOpenData/FlatVel_A/model/model32.npy
./FWIOpenData/FlatVel_A/data/data33.npy	./FWIOpenData/FlatVel_A/model/model33.npy
./FWIOpenData/FlatVel_A/data/data34.npy	./FWIOpenData/FlatVel_A/model/model34.npy
./FWIOpenData/FlatVel_A/data/data35.npy	./FWIOpenData/FlatVel_A/model/model35.npy
./FWIOpenData/FlatVel_A/data/data36.npy	./FWIOpenData/FlatVel_A/model/model36.npy
./FWIOpenData/FlatVel_A/data/data37.npy	./FWIOpenData/FlatVel_A/model/model37.npy
./FWIOpenData/FlatVel_A/data/data38.npy	./FWIOpenData/FlatVel_A/model/model38.npy
./FWIOpenData/FlatVel_A/data/data39.npy	./FWIOpenData/FlatVel_A/model/model39.npy
./FWIOpenData/FlatVel_A/data/data40.npy	./FWIOpenData/FlatVel_A/model/model40.npy
./FWIOpenData/FlatVel_A/data/data41.npy	./FWIOpenData/FlatVel_A/model/model41.npy
./FWIOpenData/FlatVel_A/data/data42.npy	./FWIOpenData/FlatVel_A/model/model42.npy
./FWIOpenData/FlatVel_A/data/data43.npy	./FWIOpenData/FlatVel_A/model/model43.npy
./FWIOpenData/FlatVel_A/data/data44.npy	./FWIOpenData/FlatVel_A/model/model44.npy
./FWIOpenData/FlatVel_A/data/data45.npy	./FWIOpenData/FlatVel_A/model/model45.npy
./FWIOpenData/FlatVel_A/data/data46.npy	./FWIOpenData/FlatVel_A/model/model46.npy
./FWIOpenData/FlatVel_A/data/data47.npy	./FWIOpenData/FlatVel_A/model/model47.npy
./FWIOpenData/FlatVel_A/data/data48.npy	./FWIOpenData/FlatVel_A/model/model48.npy
